Enigma-3D
90 90 90 90 90 90 90 90 90 90 90 90 90 90 90 90 90 90 90 90 
90 31 31 31 31 31 92 92 92 92 90 92 90 92 92 91 92 90 92 90 
90 31 31 31 31 31 90 92 90 92 90 90 90 90 91 91 92 90 92 90 
92 31 31 31 31 31 90 92 90 92 92 92 92 92 92 92 92 92 92 90 
90 31 31 31 31 31 90 92 90 90 90 90 90 92 90 90 90 90 92 90
90 31 31 31 31 31 92 92 92 92 90 92 92 92 92 90 92 92 92 90
90 90 92 90 90 90 90 90 90 92 92 92 90 90 92 90 90 90 92 90
92 91 92 92 92 92 92 90 92 92 92 92 92 90 92 90 92 92 92 90
90 90 90 90 90 90 90 90 90 90 90 90 92 90 90 90 92 90 90 90 
90 90 92 92 92 92 92 92 92 92 92 92 92 90 92 90 92 92 92 90 
90 90 92 90 90 90 92 90 90 90 90 90 90 90 92 90 93 90 90 90 
90 92 92 90 92 92 92 92 92 92 92 92 92 93 93 93 93 92 92 90 
90 90 90 90 90 90 90 90 90 90 90 90 90 90 90 90 90 90 90 90 
introduce 3 3 to 1 1
introduce 3 3 to 1 2
introduce 3 3 to 1 3
introduce 3 3 to 1 4
introduce 3 3 to 1 5
introduce 3 3 to 2 1
introduce 3 3 to 2 2
introduce 3 3 to 2 3
introduce 3 3 to 2 4
introduce 3 3 to 2 5
introduce 3 3 to 3 1
introduce 3 3 to 3 2
introduce 3 3 to 3 4
introduce 3 3 to 3 5
introduce 3 3 to 4 1
introduce 3 3 to 4 2
introduce 3 3 to 4 3
introduce 3 3 to 4 4
introduce 3 3 to 4 5
introduce 3 3 to 5 1
introduce 3 3 to 5 2
introduce 3 3 to 5 3
introduce 3 3 to 5 4
introduce 3 3 to 5 5
end

