Enigma-3D
90 90 90 90 90 90 92 90 92 90 92 90 90 90 92 91 90 90 90 90 
90 92 92 92 92 90 92 90 92 90 92 90 92 92 92 91 92 90 92 90 
90 90 92 90 92 90 90 90 90 90 90 90 90 90 91 91 92 90 92 90 
92 90 92 90 92 92 92 92 92 92 92 92 92 92 92 92 92 92 92 90 
90 90 92 90 90 90 90 90 92 92 31 92 90 90 90 90 90 90 92 90
90 92 92 92 92 90 92 92 92 31 31 31 92 92 92 90 92 92 92 90
90 90 92 90 90 90 90 90 90 92 92 92 90 90 92 90 90 90 92 90
92 91 92 92 92 92 92 90 92 92 92 92 92 90 92 90 92 92 92 90
90 90 90 90 90 90 90 90 90 90 90 90 92 90 90 90 92 90 90 90 
90 90 92 92 92 92 92 92 92 92 92 92 92 90 92 90 92 92 92 90 
90 90 92 90 90 90 92 90 90 90 90 90 90 90 92 90 93 90 90 90 
90 92 92 90 92 92 92 92 92 92 92 92 92 93 93 93 93 92 92 90 
90 90 90 90 90 90 90 90 90 90 90 90 90 90 90 90 90 90 90 90 
introduce 14 2 to 1 7
introduce 1 7 to 15 2
introduce 10 5 to 9 5 
introduce 10 5 to 11 5
introduce 10 5 to 10 4
end

