Enigma-3D
90 90 90 90 90 90 92 90 92 90 92 90 90 90 92 91 90 90 90 90 
90 92 92 92 92 90 92 90 92 90 92 90 92 92 92 91 92 90 92 90 
90 90 92 90 92 90 90 90 90 90 90 90 90 90 91 91 92 90 92 90 
92 90 92 90 92 92 31 92 92 92 92 92 92 92 92 92 92 92 92 90 
90 90 92 90 90 90 90 90 92 90 92 90 90 90 90 90 90 90 92 90
90 92 92 92 92 90 92 92 92 90 31 92 92 92 92 90 92 92 92 90
90 90 92 90 90 90 90 90 90 90 92 90 90 90 92 90 90 90 92 90
92 91 92 92 92 92 92 90 92 92 92 92 92 90 92 90 92 92 92 90
90 90 90 90 90 90 90 90 90 90 90 90 92 90 90 90 92 90 90 90 
90 90 92 92 92 92 92 92 92 92 92 92 92 90 92 90 92 92 92 90 
90 90 92 90 90 90 92 90 90 90 90 90 90 90 92 90 93 90 90 90 
90 92 92 90 92 92 92 92 92 92 92 92 92 93 93 93 93 92 92 90 
90 90 90 90 90 90 90 90 90 90 90 90 90 90 90 90 90 90 90 90 
introduce 14 2 to 1 7
introduce 1 7 to 15 2
introduce 6 3 to 6 2
introduce 6 3 to 6 4
introduce 6 3 to 5 3
introduce 6 3 to 7 3
introduce 6 7 to 6 6
introduce 6 7 to 6 8
introduce 6 7 to 5 7
introduce 6 7 to 7 7
end

